S   #   #   #   #
#       #       #
#   #       #   #
#       #       #
#   #   #   #   G